    			R 1080 720
     				NO textures/wall_n.xpm
			SO textures/wall_s.xpm
     WE textures/wall_w.xpm
EA      textures/wall_e.xpm
S 				./path_to_the_sprite_texture
F 	 	 	220  			 	 			 		,100,0
C 0, 116, 255
        1111111111111111111111111
        1000000000110000000000001
        1011000001110000002000001
        1001000000000000000000001
111111111011000001110000000000001
100000000011000001110111111111111
11110111111111011100000010001
11110111111111011101010010001
11000000110101011100000010001
10002000000000001100000010001
1000000000000N001101010010001
1100000111010101111101111000111
11110111 1110101 101111010001
11111111 1111111 111111111111
