R 10000 10000
NO textures/wall_n.xpm
SO textures/wall_s.xpm
WE textures/wall_w.xpm
EA textures/wall_e.xpm
S textures/sprite.xpm
F 220,100,0
C 0,116,255

    111111111
    10200S001
    111111111
