R 1080 720
NO textures/wall_n.xpm
SO textures/wall_s.xpm
WE textures/wall_w.xpm
EA textures/wall_e.xpm
S textures/wall_e.xpm
F 220,100,0
C 0,116,255

    11111111111111111111111111111
        1000000000110000000000001
        1011010001110000000000001
        1001000000000000000000001
111111111011000001110000000000001
100000000011000001110111111111111
11110111111111011100000010001
11110111111111011101010010001
1100000011010111100000010001
1000200100001101100000110001      111
100022000W0000000001111000001     101
11000001110101011111011110011     111
11110111 1110101 101111010001
11111111 1111111 111111111111
