R 1080 540
NO textures/wall_n.xpm
SO textures/wall_s.xpm
WE textures/wall_w.xpm
EA textures/wall_e.xpm
S textures/sprite.xpm
F 220,100,0
C 0,116,255


1111111111
1222222221
1222222221
1222222221
1222W22221
1222222221
1222222221
1111111111
