R 1080 720
NO textures/wall_n.xpm
SO textures/wall_s.xpm
WE textures/wall_w.xpm
EA textures/wall_e.xpm
S textures/sprite.xpm
F 220,100,0
C 0,116,255







1111111111
1111111111
1111111111
1000000001
1200000001
1000W00201
1000000001
1000002001
1111111111
