R 1080 720
NO textures/wall_n.xpm
S textures/sprite.xpm
SO textures/wall_s.xpm
WE textures/wall_w.xpm
EA textures/wall_e.xpm
F 220,100,0
C 0,116,255


1111111111111
100000200001
1000000000001
10000012000001
100000N000001
1000000000001
1000000000001
1111111111111
